111111111
100C00001
1PC000001
100C000E1
111111111
