11111
10P01
10E01
1CCC1
11111
