1111111111111111111111111111111111111111111111111111111111111111111111111111
10E0P00C00000000111111111111111111111111111111111111111111111111111111111111
1111111111111111111111111111111111111111111111111111111111111111111111111111
1000000000000000111111111111111111111111111111111111111111111111111111111111
1111111111111111111111111111111111111111111111111111111111111111111111111111
1000000000000000111111111111111111111111111111111111111111111111111111111111
1000000000000000111111111111111111111111111111111111111111111111111111111111
1000000000000000111111111111111111111111111111111111111111111111111111111111
1111111111111111111111111111111111111111111111111111111111111111111111111111
1111111111111111111111111111111111111111111111111111111111111111111111111111

