11111111111111
1000000001C101
100C0000010101
10C00C00000001
1P0000100E0001
10000000000001
11111111111111
