11111111111111
10000000010101
100C0000000001
10P00000000001
100000000000E1
11111111111111
