11111111111111
1000000000E001
100C0000000001
10C00C00000001
1P000010000001
10000000000001
11111111111111
